2 13 16
#################
#  *b**#1 #*****#
#*** 1* f#      #
#***###p#*#b 4  #
##*# 2* *2  *####
# #***###*#*    #
#***f   **#  #  #
# ****  *  #*#*##
#**  ***    ##4##
########* ##x#  #
# * 2  yy#   1* #
#     ** #   ***#
#################