1 13 31
###############################
#p b****#     # * #   # s #z  #
#   b  *#*****#*#s# #*#*f #  ^#
#****  f *1 f*#yfs# # f # # ^~#
########* ****#*#*#s#1# #*##~ #
########* * ~## #4#y#*# #~#   #
#    # # # # s# #^#s# #f#3# 5 #
#    * * *1*  # # # #y#f#~# y #
#****** # * 1 # #*# #*#f#*#   #
#y 1*         #*# #*#*# #s###^#
# **          * s f f f #s*   #
#*     y     #f #   # # ##    #
###############################