3 16 19
###################
#p #    b # f #   #
#f f#   s # # #*1 #
##f #   # # s # * #
#*# s#  # # # # 1*#
#*#1#   # # #s#*  #
#*# #   #*#*# # * #
#*# # 1 #1# #3# 1*#
#b# #   #*# # #* y#
#*# ##  #s#y# # * #
#y *4*#s#3#1# # 1*#
#**3**# # # # #  5#
# * *#  # #3# ###*#
# * * # # # # #2#5#
#1 *  * #*s #*32*z#
###################