1 13 31
###############################
#p b****#     # * #   # s #z  #
#   z  *#*****#*#s# #*# f #  ^#
#****b f *1 f*#yfs# # f # # ^~#
########* ****#*#*#s#1# # ##~ #
########* * ~## #4#y#*# #~#   #
#    # # # # s# #^#s# #f#1# 5 #
#    *   *1*  # # # #y#f# # y #
#****** # * 1 # #*# #*#f# #   #
#y 1*         #*# #*#*# #s###^#
# **          * s f f f #s*   #
#*     y     #f #   # # ##    #
###############################