2 13 16
#################
#  *b**#1 #*****#
#*** 1* f#      #
#***###p#*#b 4  #
##*# 2* *2y *####
# #***###*#*    #
#***f   **#  #  #
# ****  *  #*#*##
#**  ***    ##4##
########* ##z#  #
# * 2   y#   1* #
#     ** #   ***#
#################