1 13 31
###############################
#pb ****#     # *2#   #   #   #
#   *  *#*****#*# # #*#*f #   #
#**** 1* * 2f*#yf*# # f3# # y #
########*2****#*#*#*#3#*#*#   #
########* *  ## #4#y#*#*#4#  z#
#   1# # # # s# #3#1#3#f#3# 5 #
#    *2* *2*  # # #*#y#f# #  5#
#****** # * 1 # #*# #*#f#*#   #
#y 1* 2      #f # #*#*# # ### #
# **     2    **# f f f #* 3  #
#*     y     #f #   # # #  3  #
###############################