1 13 31
###############################
#p b ****#     # * #   #   #   #
#z  b  *#*****#*# # #*#*f #   #
#****  f *1 f*#yf # # f # # y #
########* ****#*#*#*#1# #*#   #
########* *  ## #4#y#*# # #   #
#    # # # # s# # # # #f#3# 5 #
#    * * *1*  # # # #y#f# #   #
#****** # * 1 # #*# #*#f#*#   #
#y 1*         #*# #*#*# # ### #
# **          * s f f f #*    #
#*     y     #f #   # # #     #
###############################