3 13 31
#####################         #
#p *##############**#         #
#y ###############**# ****    #
#  z* ~~~^ ^ ^ ^ *3y#    *    #
#***  ~~###########~#    *    #
#     ***    #  ### #    *    #
#    *1 ys   #** 1* # ****    #
#     **#    #^*y s*#    *    #
#        #####*#### #    *    #
#      ^  ~    *2y*y#    *    #
#  ###############^ # ****    #
# *###############z^#         #
#####################         #