2 13 31
######################        #
#  z     y#^         #        #
# # ######* ##### #### ####   #
#^#  #####*y#  ##z# y#    #   #
# #p * s#####  ##^#  #    #   #
# # ^#            #  #    #   #
#^# f#   2        * 3# ####   #
#^# ^#    b       *  # #      #
#s#  ############ *  # #      #
#1# ^   3 ##   ^^    # #      #
# ########*# ~~~ ##* # ####   #
#^  ^^   ^^  ~~~ ^   #        #
###############################
